X X X X X X X X X X X X X X X
X C . X . . . M . . . . . . X
X . . . . . X . . . . . . M X
X . . . X . M . . . . . X . X
X X . X . . . X X X . . X . X
X . . X M . . . . . . . X . X
X . . X . . X X X . . . . . X
X M . X . . X T X . . M . . X
X . . . . . . . . . X . . X X
X . . X X X X . . . . . . . X
X . . . . . . . . . . . X . X
X X . . M . . . X X . . M . X
X . . . . . . . . . . . . . X
X . . X . . . M . . . . . . X
X X X X X X X X X X X X X X X